//MAP CONVERTED BY dmm2tgm.py THIS HEADER COMMENT PREVENTS RECONVERSION, DO NOT REMOVE
"a" = (
/obj/structure/fans/tiny/invisible,
/obj/effect/turf_decal/box,
/turf/open/floor/mineral/titanium/white,
/area/shuttle/supply)
"i" = (
/obj/structure/fans/tiny/invisible,
/obj/machinery/light/runway/delay2,
/turf/open/floor/mineral/titanium/yellow,
/area/shuttle/supply)
"I" = (
/obj/structure/fans/tiny/invisible,
/obj/machinery/light/runway/delay3,
/turf/open/floor/mineral/titanium/white,
/area/shuttle/supply)
"K" = (
/obj/structure/fans/tiny/invisible,
/obj/effect/turf_decal/box,
/turf/open/floor/mineral/titanium/yellow,
/area/shuttle/supply)
"N" = (
/obj/structure/fans/tiny/invisible,
/obj/effect/turf_decal/loading_area{
	dir = 8
	},
/obj/machinery/light/runway,
/obj/docking_port/mobile/supply{
	dwidth = 1;
	height = 2;
	width = 3
	},
/turf/open/floor/mineral/titanium/white,
/area/shuttle/supply)

(1,1,1) = {"
K
I
K
"}
(2,1,1) = {"
a
i
a
"}
(3,1,1) = {"
K
N
K
"}
