//MAP CONVERTED BY dmm2tgm.py THIS HEADER COMMENT PREVENTS RECONVERSION, DO NOT REMOVE
"aq" = (
/obj/machinery/firealarm/directional/north,
/obj/machinery/firealarm/directional/south,
/obj/machinery/camera/autoname{
	dir = 10
	},
/turf/open/floor/monotile/steel,
/area/engine/engine_room)
"bN" = (
/obj/machinery/holopad,
/obj/structure/cable/yellow{
	icon_state = "1-2"
	},
/turf/open/floor/monotile/steel,
/area/engine/engine_room)
"eh" = (
/obj/effect/turf_decal/stripes/line{
	dir = 1
	},
/turf/open/floor/engine,
/area/engine/engine_room)
"eI" = (
/obj/structure/cable{
	icon_state = "1-2"
	},
/turf/open/floor/monotile/steel,
/area/engine/engine_room)
"gV" = (
/obj/effect/turf_decal/tile/ship/half/yellow{
	dir = 1
	},
/obj/machinery/disposal/bin,
/obj/structure/disposalpipe/trunk{
	dir = 8
	},
/turf/open/floor/monotile/dark,
/area/engine/engine_room)
"hh" = (
/obj/structure/cable/yellow{
	icon_state = "1-2"
	},
/obj/effect/landmark/start/station_engineer,
/turf/open/floor/monotile/steel,
/area/engine/engine_room)
"iB" = (
/obj/structure/cable{
	icon_state = "1-2"
	},
/obj/machinery/atmospherics/pipe/simple/supply/hidden/layer2,
/obj/machinery/atmospherics/pipe/simple/scrubbers/hidden/layer4,
/turf/open/floor/monotile/steel,
/area/engine/engine_room)
"ji" = (
/obj/structure/lattice/catwalk,
/obj/structure/grille/wall,
/obj/machinery/camera/autoname{
	dir = 6
	},
/turf/open/space/basic,
/area/engine/engine_room)
"jI" = (
/obj/effect/turf_decal/tile/ship/half/yellow,
/obj/machinery/power/solar_control{
	dir = 1
	},
/obj/structure/cable/yellow,
/obj/item/radio/intercom/directional/south,
/turf/open/floor/monotile/dark,
/area/engine/engine_room)
"jR" = (
/obj/structure/cable/yellow{
	icon_state = "4-8"
	},
/obj/machinery/atmospherics/pipe/simple/purple/hidden{
	dir = 9
	},
/obj/machinery/atmospherics/pipe/simple/supply/hidden/layer2{
	dir = 5
	},
/obj/machinery/atmospherics/pipe/simple/scrubbers/hidden/layer4{
	dir = 5
	},
/turf/open/floor/monotile/steel,
/area/engine/engine_room)
"kG" = (
/obj/structure/cable/yellow{
	icon_state = "1-2"
	},
/obj/structure/cable{
	icon_state = "4-8"
	},
/turf/open/floor/monotile/steel,
/area/engine/engine_room)
"kX" = (
/turf/open/floor/monotile/steel,
/area/engine/engine_room)
"lR" = (
/obj/effect/turf_decal/tile/ship/half/yellow{
	dir = 8
	},
/obj/machinery/atmospherics/pipe/simple/scrubbers/hidden/layer4{
	dir = 6
	},
/obj/machinery/atmospherics/pipe/simple/supply/hidden/layer2{
	dir = 6
	},
/obj/structure/cable{
	icon_state = "1-2"
	},
/turf/open/floor/monotile/dark,
/area/engine/engine_room)
"mC" = (
/obj/effect/spawner/structure/window/plasma/reinforced,
/turf/open/floor/plating,
/area/engine/engine_room)
"mN" = (
/obj/machinery/atmospherics/pipe/simple/purple/hidden{
	dir = 4
	},
/obj/structure/cable/yellow{
	icon_state = "4-8"
	},
/obj/machinery/door/airlock/ship/external/glass{
	name = "Engine Core Access";
	req_one_access_txt = "24;10"
	},
/turf/open/floor/engine,
/area/engine/engine_room)
"nh" = (
/obj/effect/turf_decal/stripes/line{
	dir = 4
	},
/obj/machinery/atmospherics/pipe/simple/purple/hidden{
	dir = 4
	},
/obj/structure/cable/yellow{
	icon_state = "4-8"
	},
/turf/open/floor/engine,
/area/engine/engine_room)
"pb" = (
/obj/structure/cable{
	icon_state = "1-4"
	},
/obj/machinery/atmospherics/pipe/simple/scrubbers/hidden/layer4,
/obj/machinery/atmospherics/pipe/simple/supply/hidden/layer2,
/obj/structure/cable{
	icon_state = "1-8"
	},
/obj/structure/cable{
	icon_state = "4-8"
	},
/turf/open/floor/monotile/steel,
/area/engine/engine_room)
"pA" = (
/obj/effect/turf_decal/tile/ship/half/yellow,
/obj/structure/closet/secure_closet/engineering_personal,
/obj/item/clothing/head/radiation,
/obj/item/clothing/suit/radiation,
/obj/machinery/light{
	dir = 4
	},
/obj/machinery/light_switch/east,
/obj/item/clothing/glasses/meson/engine,
/turf/open/floor/monotile/dark,
/area/engine/engine_room)
"pJ" = (
/obj/machinery/atmospherics/pipe/simple/scrubbers/hidden{
	dir = 4
	},
/turf/closed/wall/r_wall,
/area/engine/engine_room)
"qz" = (
/obj/machinery/particle_accelerator/control_box,
/obj/effect/turf_decal/stripes/line{
	dir = 1
	},
/turf/open/floor/engine,
/area/engine/engine_room)
"sy" = (
/obj/machinery/door/firedoor/border_only{
	dir = 8
	},
/obj/machinery/door/firedoor/border_only{
	dir = 4
	},
/obj/effect/landmark/zebra_interlock_point,
/obj/structure/cable{
	icon_state = "4-8"
	},
/obj/machinery/atmospherics/pipe/simple/supply/hidden/layer2{
	dir = 4
	},
/obj/machinery/door/airlock/ship/maintenance{
	dir = 4
	},
/turf/open/floor/monotile/steel,
/area/engine/engine_room)
"ta" = (
/obj/structure/cable/yellow{
	icon_state = "4-8"
	},
/obj/machinery/atmospherics/pipe/simple/purple/hidden{
	dir = 4
	},
/turf/open/floor/monotile/steel,
/area/engine/engine_room)
"ug" = (
/obj/structure/cable{
	icon_state = "4-8"
	},
/obj/structure/cable{
	icon_state = "0-8"
	},
/obj/machinery/power/smes/engineering,
/turf/open/floor/monotile/steel,
/area/engine/engine_room)
"uk" = (
/obj/effect/turf_decal/tile/ship/half/yellow,
/obj/structure/reagent_dispensers/foamtank/hull_repair_juice,
/obj/item/extinguisher/advanced/hull_repair_juice,
/turf/open/floor/monotile/dark,
/area/engine/engine_room)
"ux" = (
/obj/effect/turf_decal/stripes/line{
	dir = 10
	},
/turf/open/floor/engine,
/area/engine/engine_room)
"uy" = (
/obj/structure/closet/secure_closet/engineering_personal,
/obj/item/clothing/head/radiation,
/obj/item/clothing/suit/radiation,
/obj/item/clothing/glasses/meson/engine,
/turf/open/floor/monotile/steel,
/area/engine/engine_room)
"vA" = (
/obj/structure/cable{
	icon_state = "1-2"
	},
/obj/machinery/atmospherics/pipe/simple/scrubbers/hidden/layer4,
/obj/machinery/atmospherics/pipe/simple/supply/hidden/layer2,
/obj/machinery/light{
	dir = 4
	},
/obj/structure/extinguisher_cabinet/east,
/turf/open/floor/monotile/steel,
/area/engine/engine_room)
"vY" = (
/obj/effect/spawner/structure/window/reinforced,
/obj/machinery/door/poddoor/shutters/preopen{
	id = "atlas_engineering"
	},
/turf/open/floor/plating,
/area/engine/engine_room)
"wa" = (
/obj/effect/turf_decal/tile/ship/half/yellow,
/obj/structure/tank_dispenser,
/turf/open/floor/monotile/dark,
/area/engine/engine_room)
"wt" = (
/obj/effect/turf_decal/stripes/line{
	dir = 8
	},
/obj/machinery/atmospherics/pipe/simple/scrubbers/hidden{
	dir = 4
	},
/obj/machinery/light{
	dir = 8
	},
/turf/open/floor/engine,
/area/engine/engine_room)
"wB" = (
/obj/structure/cable/yellow{
	icon_state = "4-8"
	},
/obj/machinery/power/terminal{
	dir = 1
	},
/obj/structure/cable/yellow{
	icon_state = "0-8"
	},
/turf/open/floor/monotile/steel,
/area/engine/engine_room)
"yh" = (
/obj/effect/turf_decal/tile/ship/half/yellow{
	dir = 4
	},
/obj/structure/table/reinforced,
/obj/machinery/fax{
	fax_name = "Engineering";
	name = "Engineerings Fax Machine";
	pixel_y = 8
	},
/obj/machinery/button/door{
	id = "atlas_engineering";
	name = "Engineering Shutters";
	pixel_x = 23;
	pixel_y = 18
	},
/turf/open/floor/monotile/dark,
/area/engine/engine_room)
"yx" = (
/obj/structure/lattice/catwalk,
/obj/structure/grille/wall,
/turf/open/space/basic,
/area/engine/engine_room)
"yA" = (
/obj/structure/cable/yellow{
	icon_state = "4-8"
	},
/obj/structure/cable{
	icon_state = "1-2"
	},
/obj/machinery/atmospherics/pipe/simple/scrubbers/hidden/layer4{
	dir = 10
	},
/obj/machinery/atmospherics/pipe/manifold/supply/hidden/layer2{
	dir = 1
	},
/turf/open/floor/monotile/steel,
/area/engine/engine_room)
"yS" = (
/obj/effect/turf_decal/stripes/line,
/turf/open/floor/engine,
/area/engine/engine_room)
"zm" = (
/turf/closed/wall/r_wall,
/area/engine/engine_room)
"zX" = (
/obj/structure/cable/yellow{
	icon_state = "4-8"
	},
/turf/open/floor/monotile/steel,
/area/engine/engine_room)
"zZ" = (
/obj/effect/spawner/structure/window/plasma/reinforced,
/obj/machinery/door/poddoor/shutters/preopen{
	id = "atlas_engine_atmo_shutters"
	},
/turf/open/floor/plating,
/area/engine/engine_room)
"Ao" = (
/obj/effect/turf_decal/tile/ship/yellow{
	dir = 8
	},
/obj/structure/cable{
	icon_state = "2-4"
	},
/turf/open/floor/monotile/dark,
/area/engine/engine_room)
"AB" = (
/obj/machinery/door/firedoor/border_only,
/obj/machinery/door/firedoor/border_only{
	dir = 1
	},
/obj/structure/cable/yellow{
	icon_state = "1-2"
	},
/obj/effect/landmark/zebra_interlock_point,
/obj/machinery/door/airlock/ship/engineering/glass{
	name = "Engineering";
	req_one_access_txt = "24;10"
	},
/turf/open/floor/plating,
/area/engine/engine_room)
"AL" = (
/obj/effect/turf_decal/tile/ship/half/yellow{
	dir = 4
	},
/obj/structure/cable{
	icon_state = "2-8";
	tag = ""
	},
/turf/open/floor/monotile/dark,
/area/engine/engine_room)
"BK" = (
/obj/structure/sign/warning/radiation,
/turf/closed/wall/r_wall,
/area/engine/engine_room)
"Ch" = (
/obj/structure/cable{
	icon_state = "1-4"
	},
/obj/machinery/atmospherics/pipe/simple/scrubbers/hidden/layer4,
/obj/machinery/atmospherics/pipe/simple/supply/hidden/layer2{
	dir = 1
	},
/obj/structure/disposalpipe/segment{
	dir = 5
	},
/obj/machinery/atmospherics/pipe/simple/purple/hidden,
/turf/open/floor/monotile/steel,
/area/engine/engine_room)
"Cm" = (
/obj/structure/cable{
	icon_state = "1-2"
	},
/obj/structure/cable{
	icon_state = "1-4"
	},
/obj/machinery/atmospherics/pipe/simple/supply/hidden/layer2,
/obj/machinery/atmospherics/pipe/manifold/scrubbers/hidden/layer4{
	dir = 8
	},
/turf/open/floor/monotile/steel,
/area/engine/engine_room)
"Co" = (
/obj/structure/cable/yellow{
	icon_state = "0-4"
	},
/obj/machinery/atmospherics/components/binary/stormdrive_reactor{
	reactor_id = "atlas_69420"
	},
/obj/effect/landmark/nuclear_waste_spawner/strong,
/turf/open/floor/engine,
/area/engine/engine_room)
"CL" = (
/obj/effect/turf_decal/stripes/line{
	dir = 9
	},
/turf/open/floor/engine,
/area/engine/engine_room)
"CV" = (
/obj/effect/turf_decal/stripes/line{
	dir = 5
	},
/turf/open/floor/engine,
/area/engine/engine_room)
"DU" = (
/obj/structure/extinguisher_cabinet/north,
/obj/structure/cable/yellow{
	icon_state = "4-8"
	},
/obj/machinery/atmospherics/pipe/simple/purple/hidden{
	dir = 4
	},
/turf/open/floor/monotile/steel,
/area/engine/engine_room)
"DW" = (
/obj/structure/particle_accelerator/end_cap{
	dir = 8
	},
/obj/effect/turf_decal/stripes/line{
	dir = 4
	},
/turf/open/floor/engine,
/area/engine/engine_room)
"DY" = (
/obj/structure/cable/yellow{
	icon_state = "4-8"
	},
/obj/machinery/atmospherics/pipe/simple/scrubbers/hidden/layer4{
	dir = 9
	},
/obj/machinery/atmospherics/pipe/simple/supply/hidden/layer2{
	dir = 9
	},
/turf/open/floor/monotile/steel,
/area/engine/engine_room)
"EV" = (
/obj/effect/spawner/structure/window/reinforced,
/turf/open/floor/plating,
/area/engine/engine_room)
"EX" = (
/obj/structure/cable{
	icon_state = "1-2"
	},
/obj/machinery/door/firedoor/border_only{
	dir = 1
	},
/obj/effect/landmark/zebra_interlock_point,
/obj/machinery/door/firedoor/border_only,
/obj/machinery/door/airlock/ship/maintenance,
/turf/open/floor/monotile/steel,
/area/engine/engine_room)
"Fc" = (
/obj/effect/turf_decal/tile/ship/yellow,
/obj/effect/turf_decal/tile/ship/yellow{
	dir = 4
	},
/obj/effect/turf_decal/tile/ship/yellow{
	dir = 8
	},
/obj/structure/sign/poster/official/random{
	pixel_x = 32
	},
/obj/machinery/computer/monitor{
	dir = 1
	},
/obj/structure/cable,
/turf/open/floor/monotile/dark,
/area/engine/engine_room)
"Fs" = (
/obj/effect/landmark/zebra_interlock_point,
/obj/machinery/door/firedoor/border_only{
	dir = 1
	},
/obj/machinery/door/firedoor/border_only,
/obj/structure/disposalpipe/segment,
/obj/machinery/atmospherics/pipe/simple/purple/hidden,
/obj/machinery/atmospherics/pipe/simple/supply/hidden/layer2{
	dir = 1
	},
/obj/structure/cable{
	icon_state = "1-2"
	},
/obj/machinery/door/airlock/ship/engineering/glass{
	name = "Engineering";
	req_one_access_txt = "24;10"
	},
/turf/open/floor/monotile/steel,
/area/engine/engine_room)
"Ft" = (
/obj/machinery/atmospherics/pipe/layer_manifold,
/obj/structure/closet/crate{
	icon_state = "engi_crate"
	},
/obj/item/control_rod,
/obj/item/control_rod,
/obj/item/control_rod,
/obj/item/control_rod,
/obj/item/control_rod,
/turf/open/floor/engine,
/area/engine/engine_room)
"Fv" = (
/obj/effect/turf_decal/tile/ship/yellow{
	dir = 1
	},
/obj/effect/turf_decal/tile/ship/yellow{
	dir = 8
	},
/obj/effect/turf_decal/tile/ship/yellow,
/obj/machinery/power/port_gen/pacman,
/obj/item/stack/sheet/mineral/plasma/twenty,
/obj/item/stack/cable_coil,
/turf/open/floor/monotile/dark,
/area/engine/engine_room)
"FJ" = (
/obj/effect/spawner/structure/window/reinforced,
/obj/structure/cable{
	icon_state = "4-8"
	},
/turf/open/floor/plating,
/area/engine/engine_room)
"FX" = (
/obj/structure/cable{
	icon_state = "4-8"
	},
/obj/machinery/camera/autoname{
	dir = 1
	},
/obj/machinery/atmospherics/components/unary/vent_scrubber/on/layer4{
	dir = 8
	},
/turf/open/floor/monotile/steel,
/area/engine/engine_room)
"GE" = (
/obj/machinery/atmospherics/pipe/simple/purple/hidden{
	dir = 4
	},
/obj/structure/cable/yellow{
	icon_state = "4-8"
	},
/obj/machinery/atmospherics/pipe/simple/supply/hidden/layer2{
	dir = 6
	},
/obj/machinery/atmospherics/pipe/simple/scrubbers/hidden/layer4{
	dir = 5
	},
/obj/machinery/atmospherics/components/binary/dp_vent_pump{
	dir = 1
	},
/turf/open/floor/engine,
/area/engine/engine_room)
"GM" = (
/obj/effect/turf_decal/tile/ship/half/yellow{
	dir = 1
	},
/obj/machinery/suit_storage_unit/engine,
/turf/open/floor/monotile/dark,
/area/engine/engine_room)
"GW" = (
/obj/structure/cable/yellow{
	icon_state = "4-8"
	},
/obj/machinery/atmospherics/pipe/simple/purple/hidden{
	dir = 4
	},
/obj/machinery/atmospherics/pipe/simple/supply/hidden/layer2{
	dir = 4
	},
/obj/machinery/atmospherics/pipe/simple/scrubbers/hidden/layer4{
	dir = 8
	},
/obj/machinery/door/airlock/ship/external/glass{
	name = "Engine Core Access";
	req_one_access_txt = "24;10"
	},
/turf/open/floor/engine,
/area/engine/engine_room)
"HA" = (
/obj/machinery/light{
	brightness = 3;
	bulb_vacuum_brightness = 2;
	nightshift_brightness = 1
	},
/obj/structure/extinguisher_cabinet/south,
/obj/machinery/light_switch/south{
	pixel_x = 11
	},
/obj/structure/cable/yellow{
	icon_state = "4-8"
	},
/turf/open/floor/monotile/steel,
/area/engine/engine_room)
"Ih" = (
/obj/structure/table/reinforced,
/obj/item/clothing/gloves/color/yellow,
/obj/item/clothing/gloves/color/yellow,
/obj/item/storage/belt/utility/full,
/obj/item/storage/belt/utility/full,
/obj/item/storage/toolbox/mechanical,
/turf/open/floor/monotile/dark,
/area/engine/engine_room)
"Iq" = (
/mob/living/simple_animal/bot/floorbot,
/obj/effect/landmark/event_spawn,
/turf/open/floor/monotile/steel,
/area/engine/engine_room)
"Ja" = (
/obj/machinery/atmospherics/pipe/layer_manifold,
/obj/machinery/advanced_airlock_controller/directional/south,
/turf/open/floor/engine,
/area/engine/engine_room)
"Jb" = (
/obj/effect/turf_decal/tile/ship/half/yellow{
	dir = 8
	},
/obj/structure/cable/yellow{
	icon_state = "1-4"
	},
/turf/open/floor/monotile/dark,
/area/engine/engine_room)
"Jc" = (
/obj/structure/particle_accelerator/fuel_chamber{
	dir = 8
	},
/turf/open/floor/engine,
/area/engine/engine_room)
"JF" = (
/obj/effect/turf_decal/tile/ship/half/yellow{
	dir = 8
	},
/obj/structure/cable/yellow{
	icon_state = "2-8"
	},
/obj/structure/cable/yellow{
	icon_state = "1-8"
	},
/obj/machinery/atmospherics/pipe/simple/purple/hidden{
	dir = 9
	},
/turf/open/floor/monotile/dark,
/area/engine/engine_room)
"Kc" = (
/obj/effect/turf_decal/stripes/line{
	dir = 1
	},
/obj/machinery/computer/ship/reactor_control_computer{
	dir = 1;
	reactor_id = "atlas_69420"
	},
/obj/item/book/manual/wiki/stormdrive,
/turf/open/floor/engine,
/area/engine/engine_room)
"KB" = (
/obj/effect/turf_decal/tile/ship/half/yellow,
/obj/machinery/light,
/obj/machinery/computer/station_alert{
	dir = 1;
	name = "ship alert console"
	},
/obj/structure/cable,
/obj/machinery/light_switch/south,
/turf/open/floor/monotile/dark,
/area/engine/engine_room)
"KG" = (
/obj/machinery/telecomms/relay/preset/station{
	name = "Telecommunications Relay Cupboard"
	},
/obj/machinery/door/window/westright{
	req_one_access_txt = "10";
	name = "Telecommunications Relay Cupboard"
	},
/obj/structure/window/reinforced{
	dir = 1
	},
/turf/open/floor/plasteel/tech/grid,
/area/engine/engine_room)
"KS" = (
/obj/effect/turf_decal/tile/ship/half/yellow{
	dir = 1
	},
/obj/structure/closet/radiation,
/obj/item/geiger_counter,
/turf/open/floor/monotile/dark,
/area/engine/engine_room)
"LR" = (
/obj/effect/turf_decal/tile/ship/half/yellow{
	dir = 4
	},
/obj/item/rcl/pre_loaded,
/obj/item/storage/box/lights/mixed,
/obj/item/stack/cable_coil/red,
/obj/item/stack/package_wrap{
	pixel_x = -3;
	pixel_y = 8
	},
/obj/item/dest_tagger{
	pixel_x = 9
	},
/obj/machinery/power/apc/auto_name/east,
/obj/structure/cable{
	icon_state = "0-8"
	},
/obj/structure/table/reinforced,
/turf/open/floor/monotile/dark,
/area/engine/engine_room)
"MB" = (
/obj/machinery/light{
	dir = 1
	},
/obj/effect/turf_decal/tile/ship/half/yellow{
	dir = 1
	},
/obj/structure/filingcabinet/chestdrawer,
/obj/machinery/light_switch/north,
/turf/open/floor/monotile/dark,
/area/engine/engine_room)
"MG" = (
/turf/template_noop,
/area/template_noop)
"OO" = (
/obj/machinery/power/terminal{
	dir = 1
	},
/obj/structure/cable/yellow{
	icon_state = "0-8"
	},
/obj/machinery/light/small{
	dir = 4
	},
/obj/structure/extinguisher_cabinet/east,
/turf/open/floor/monotile/steel,
/area/engine/engine_room)
"PL" = (
/obj/structure/cable/yellow{
	icon_state = "4-8"
	},
/obj/machinery/atmospherics/components/unary/vent_pump/on/layer2{
	dir = 8
	},
/turf/open/floor/monotile/steel,
/area/engine/engine_room)
"QA" = (
/obj/effect/turf_decal/tile/ship/half/yellow{
	dir = 1
	},
/obj/effect/spawner/lootdrop/techstorage/engineering,
/obj/machinery/airalarm/directional/north,
/obj/structure/table/reinforced,
/turf/open/floor/monotile/dark,
/area/engine/engine_room)
"QD" = (
/obj/effect/turf_decal/tile/ship/half/yellow{
	dir = 8
	},
/obj/machinery/atmospherics/pipe/simple/scrubbers/hidden/layer4{
	dir = 9
	},
/obj/machinery/atmospherics/pipe/simple/supply/hidden/layer2{
	dir = 9
	},
/obj/structure/cable{
	icon_state = "1-8"
	},
/turf/open/floor/monotile/dark,
/area/engine/engine_room)
"QK" = (
/obj/machinery/door/firedoor/border_only/directional/south{
	dir = 4
	},
/obj/machinery/door/firedoor/border_only/directional/north{
	dir = 8
	},
/obj/effect/landmark/zebra_interlock_point,
/obj/machinery/door/window/westright{
	name = "Engineering Desk";
	req_one_access_txt = "24;10"
	},
/obj/machinery/door/window/northright{
	dir = 4
	},
/obj/machinery/door/poddoor/shutters/preopen{
	id = "atlas_engineering"
	},
/obj/structure/table/reinforced,
/obj/item/paper_bin,
/obj/item/pen,
/obj/item/stamp,
/obj/item/stamp/denied{
	pixel_y = 10
	},
/turf/open/floor/plating,
/area/engine/engine_room)
"Rb" = (
/obj/structure/particle_accelerator/power_box{
	dir = 8
	},
/turf/open/floor/engine,
/area/engine/engine_room)
"Rm" = (
/obj/structure/cable/yellow{
	icon_state = "1-2"
	},
/obj/effect/turf_decal/tile/ship/half/yellow,
/turf/open/floor/monotile/dark,
/area/engine/engine_room)
"Rp" = (
/obj/structure/cable/yellow{
	icon_state = "1-2"
	},
/obj/structure/cable/yellow{
	icon_state = "1-4"
	},
/obj/machinery/atmospherics/pipe/simple/scrubbers/hidden/layer4{
	dir = 4
	},
/obj/machinery/atmospherics/pipe/simple/supply/hidden/layer2{
	dir = 4
	},
/turf/open/floor/monotile/steel,
/area/engine/engine_room)
"Sg" = (
/obj/structure/cable{
	icon_state = "0-8"
	},
/obj/machinery/power/smes/engineering,
/obj/structure/sign/poster/official/random{
	pixel_x = 32
	},
/turf/open/floor/monotile/steel,
/area/engine/engine_room)
"Sl" = (
/obj/structure/lattice/catwalk,
/obj/machinery/atmospherics/components/unary/outlet_injector/on{
	dir = 4
	},
/turf/open/space/basic,
/area/engine/engine_room)
"SQ" = (
/obj/machinery/door/firedoor/border_only{
	dir = 4
	},
/obj/machinery/door/firedoor/border_only{
	dir = 8
	},
/obj/effect/landmark/zebra_interlock_point,
/obj/structure/cable/yellow{
	icon_state = "4-8"
	},
/obj/machinery/door/airlock/ship/engineering/glass{
	name = "SMES Power Storage";
	req_one_access_txt = "24;10";
	dir = 8
	},
/turf/open/floor/monotile/dark,
/area/engine/engine_room)
"SR" = (
/obj/structure/cable{
	icon_state = "1-2"
	},
/obj/machinery/atmospherics/pipe/simple/scrubbers/hidden/layer4,
/obj/machinery/atmospherics/pipe/simple/supply/hidden/layer2,
/turf/open/floor/monotile/steel,
/area/engine/engine_room)
"Tk" = (
/obj/effect/turf_decal/tile/ship/half/yellow{
	dir = 8
	},
/obj/structure/cable/yellow{
	icon_state = "1-2"
	},
/obj/machinery/atmospherics/components/binary/pump{
	name = "Engine Mix to Engine"
	},
/turf/open/floor/monotile/dark,
/area/engine/engine_room)
"TY" = (
/obj/structure/particle_accelerator/particle_emitter/left{
	dir = 8
	},
/obj/effect/turf_decal/stripes/line{
	dir = 9
	},
/turf/open/floor/engine,
/area/engine/engine_room)
"Uu" = (
/obj/effect/turf_decal/tile/ship/half/yellow{
	dir = 8
	},
/obj/structure/cable/yellow{
	icon_state = "2-4"
	},
/obj/machinery/atmospherics/pipe/simple/purple/hidden{
	dir = 6
	},
/obj/structure/sign/warning/enginesafety{
	pixel_x = -32
	},
/turf/open/floor/monotile/dark,
/area/engine/engine_room)
"Vo" = (
/obj/structure/table/reinforced,
/obj/machinery/power/battery{
	pixel_x = -4;
	pixel_y = 4
	},
/obj/machinery/power/battery{
	pixel_y = 6;
	pixel_x = 7
	},
/obj/machinery/power/battery{
	pixel_x = -7
	},
/obj/machinery/power/battery{
	pixel_x = 9
	},
/turf/open/floor/monotile/steel,
/area/engine/engine_room)
"Vt" = (
/obj/machinery/power/terminal{
	dir = 1
	},
/obj/structure/cable/yellow{
	icon_state = "4-8"
	},
/obj/structure/cable/yellow{
	icon_state = "0-8"
	},
/turf/open/floor/monotile/steel,
/area/engine/engine_room)
"VS" = (
/obj/structure/cable{
	icon_state = "2-8";
	tag = ""
	},
/obj/structure/cable{
	icon_state = "4-8"
	},
/obj/structure/cable{
	icon_state = "1-8"
	},
/obj/structure/chair/office,
/obj/effect/landmark/start/station_engineer,
/turf/open/floor/monotile/steel,
/area/engine/engine_room)
"Xp" = (
/obj/structure/cable{
	icon_state = "2-4"
	},
/turf/open/floor/monotile/steel,
/area/engine/engine_room)
"Yd" = (
/obj/effect/turf_decal/tile/ship/half/yellow{
	dir = 8
	},
/obj/structure/cable/yellow{
	icon_state = "1-2"
	},
/turf/open/floor/monotile/dark,
/area/engine/engine_room)
"Yh" = (
/obj/effect/turf_decal/stripes/line{
	dir = 6
	},
/turf/open/floor/engine,
/area/engine/engine_room)
"Yi" = (
/obj/structure/particle_accelerator/particle_emitter/center{
	dir = 8
	},
/obj/effect/turf_decal/stripes/line{
	dir = 8
	},
/turf/open/floor/engine,
/area/engine/engine_room)
"Ym" = (
/obj/effect/turf_decal/tile/ship/half/yellow{
	dir = 1
	},
/obj/structure/cable{
	icon_state = "2-8"
	},
/obj/structure/disposalpipe/segment{
	dir = 8
	},
/turf/open/floor/monotile/dark,
/area/engine/engine_room)
"Yu" = (
/obj/structure/cable/yellow{
	icon_state = "2-8"
	},
/turf/open/floor/monotile/steel,
/area/engine/engine_room)
"ZS" = (
/obj/structure/particle_accelerator/particle_emitter/right{
	dir = 8
	},
/obj/effect/turf_decal/stripes/line{
	dir = 10
	},
/turf/open/floor/engine,
/area/engine/engine_room)
"ZY" = (
/obj/effect/turf_decal/tile/ship/half/yellow{
	dir = 1
	},
/obj/machinery/light{
	dir = 1
	},
/obj/machinery/light_switch/north,
/obj/structure/closet/radiation,
/obj/item/geiger_counter,
/turf/open/floor/monotile/dark,
/area/engine/engine_room)

(1,1,1) = {"
MG
zm
zm
zm
zm
zm
mC
mC
mC
mC
mC
zm
zm
zm
zm
zm
MG
MG
"}
(2,1,1) = {"
zm
zm
kX
kX
kX
zm
zm
ji
Sl
yx
zm
zm
kX
kX
kX
zm
zm
MG
"}
(3,1,1) = {"
zm
kX
kX
kX
kX
zm
zm
zm
pJ
zm
zm
zm
kX
kX
kX
kX
zm
MG
"}
(4,1,1) = {"
zZ
kX
kX
kX
kX
zm
zm
CL
wt
ux
zm
zm
kX
kX
kX
kX
zm
MG
"}
(5,1,1) = {"
zZ
kX
kX
kX
kX
zm
zm
eh
Co
yS
zm
zm
kX
kX
kX
kX
zm
zm
"}
(6,1,1) = {"
zm
kX
kX
kX
kX
zm
zm
CV
nh
Yh
zm
zm
kX
kX
kX
kX
kX
mC
"}
(7,1,1) = {"
zm
kX
kX
kX
kX
zm
zm
mC
mN
mC
zm
zm
kX
kX
kX
kX
kX
mC
"}
(8,1,1) = {"
zm
kX
kX
kX
kX
zm
zm
Ft
GE
Ja
zm
zm
kX
kX
kX
kX
kX
zm
"}
(9,1,1) = {"
zm
kX
kX
kX
kX
zm
zm
mC
GW
mC
BK
zm
kX
kX
kX
kX
kX
zm
"}
(10,1,1) = {"
zm
kX
kX
kX
kX
EX
Uu
Tk
JF
Yd
Jb
zm
kX
kX
kX
kX
kX
zm
"}
(11,1,1) = {"
zm
kX
kX
kX
kX
zm
DU
TY
Yi
ZS
HA
zm
zm
kX
kX
kX
zm
zm
"}
(12,1,1) = {"
zm
zm
zm
zm
zm
zm
ta
Kc
Rb
yS
zX
zm
zm
kX
kX
zm
zm
MG
"}
(13,1,1) = {"
MG
MG
MG
MG
zm
GM
ta
qz
Jc
yS
zX
wa
zm
kX
kX
zm
MG
MG
"}
(14,1,1) = {"
MG
MG
MG
MG
zm
ZY
ta
CV
DW
Yh
zX
uk
zm
sy
zm
zm
MG
MG
"}
(15,1,1) = {"
MG
MG
MG
MG
EV
KS
ta
kX
kX
kX
zX
Ao
lR
QD
Fv
zm
MG
MG
"}
(16,1,1) = {"
MG
MG
MG
MG
Fs
Ch
jR
kX
kX
kX
Yu
kG
Rp
hh
Rm
AB
MG
MG
"}
(17,1,1) = {"
MG
MG
MG
MG
EV
Ym
yA
iB
Cm
vA
SR
pb
DY
uy
pA
zm
MG
MG
"}
(18,1,1) = {"
MG
MG
MG
MG
zm
gV
PL
Iq
FX
zm
zm
FJ
SQ
EV
zm
zm
MG
MG
"}
(19,1,1) = {"
MG
MG
MG
MG
zm
MB
Yu
bN
kG
jI
zm
ug
wB
kX
Vo
zm
MG
MG
"}
(20,1,1) = {"
MG
MG
MG
MG
zm
QA
Xp
eI
VS
KB
zm
ug
Vt
aq
zm
zm
MG
MG
"}
(21,1,1) = {"
MG
MG
MG
MG
zm
Ih
LR
yh
AL
Fc
zm
Sg
OO
KG
zm
MG
MG
MG
"}
(22,1,1) = {"
MG
MG
MG
MG
zm
zm
zm
vY
QK
zm
zm
zm
zm
zm
zm
MG
MG
MG
"}
